22 22
100 100
4 4 4 4 4 4 4 4 4 4 4 4 4 4 4 4 4 4 4 4 4 4
4 1 1 1 1 1 1 1 1 1 1 1 1 1 1 1 1 1 1 1 1 4
4 1 0 0 0 0 0 0 0 0 0 0 0 0 0 0 0 0 0 0 1 4
4 1 0 3 3 0 0 0 0 0 3 0 0 0 0 0 0 0 0 0 1 4
4 1 0 3 3 2 0 0 0 0 2 0 0 0 0 0 0 1 0 0 1 4
4 1 0 0 0 0 0 0 0 0 3 0 0 0 0 0 0 1 0 0 1 4
4 1 0 0 0 0 0 0 0 0 2 0 0 0 0 0 0 1 0 0 1 4
4 1 0 0 0 0 0 1 1 1 1 1 1 1 0 0 0 1 0 0 1 4
4 1 0 0 0 0 0 1 0 0 0 0 0 1 0 0 0 1 0 0 1 4
4 1 0 0 0 0 0 1 0 3 3 3 0 1 0 0 0 1 0 0 1 4
4 1 1 1 1 1 1 1 0 3 0 3 0 1 0 0 0 1 0 0 1 4
4 1 0 0 1 0 0 1 0 3 3 3 0 1 0 0 0 1 0 0 1 4
4 1 0 0 1 0 0 1 0 0 0 0 0 1 0 0 0 1 0 0 1 4
4 1 0 0 1 0 0 1 1 1 1 1 1 1 0 0 0 1 0 0 1 4
4 1 0 0 1 0 0 0 0 0 1 0 0 0 0 0 0 1 0 0 1 4
4 1 0 0 1 0 0 0 0 0 1 0 0 0 0 0 0 1 0 0 1 4
4 1 0 0 1 0 0 0 0 0 1 0 0 0 0 0 0 1 0 0 1 4
4 1 0 0 1 1 1 1 1 1 1 1 1 1 1 1 1 1 0 0 1 4
4 1 0 0 0 0 0 0 0 0 1 0 0 0 0 0 0 0 0 0 1 4
4 1 0 0 0 0 0 0 0 0 1 0 0 0 0 0 0 0 0 0 1 4
4 1 1 1 1 1 1 1 1 1 1 1 1 1 1 1 1 1 1 1 1 4
4 4 4 4 4 4 4 4 4 4 4 4 4 4 4 4 4 4 4 4 4 4